Inventory_Level_Before,Inventory_Level_After,Employee_Access_Count,Shipment_Received,Time_of_Access,Day_of_Week,Theft_Reported,Theft_Loss
4174,4322,18,0,20,3,0,-148
4507,1876,7,0,12,6,0,2631
1860,2028,3,0,20,2,1,-168
2294,4190,18,0,7,2,0,-1896
2130,2015,10,0,13,6,0,115
2095,2824,7,0,7,5,1,-729
4772,1373,17,0,13,4,1,3399
4092,4136,14,0,6,2,0,-44
2638,3193,3,0,22,1,0,-555
3169,1223,12,0,11,3,1,1946
1466,2262,13,0,10,6,1,-796
2238,3224,2,0,21,1,1,-986
1330,2802,3,0,21,6,1,-1472
2482,1852,5,0,10,7,1,630
3135,4353,11,0,21,3,1,-1218
4444,1062,8,0,12,3,1,3382
4171,2240,12,0,17,2,0,1931
3919,4925,7,0,1,2,1,-1006
4735,3874,15,0,20,1,1,861
1130,3842,17,0,14,7,0,-2712
2685,1688,4,0,19,6,1,997
4380,2484,13,0,17,7,1,1896
1769,2633,18,0,14,3,0,-864
3391,3152,1,0,18,1,1,239
2515,4170,16,0,22,4,0,-1655
4485,1510,13,0,23,1,0,2975
3853,1384,10,0,11,5,0,2469
3433,1404,12,0,12,1,0,2029
2215,3870,2,0,21,7,1,-1655
1955,1517,3,0,10,5,0,438
3324,1475,10,0,4,5,0,1849
2184,3000,2,0,0,5,1,-816
1459,3756,13,0,23,4,0,-2297
4385,4934,13,0,2,1,0,-549
1021,2668,18,0,21,7,0,-1647
3300,2893,3,0,18,1,0,407
1747,3818,7,0,22,4,1,-2071
3904,2460,14,0,6,3,0,1444
4632,4094,17,0,11,2,1,538
1474,4044,12,0,14,7,1,-2570
2082,4636,16,0,4,7,0,-2554
3558,3724,12,0,14,1,0,-166
4753,1713,15,0,7,2,0,3040
3047,4529,10,0,9,6,0,-1482
4547,1082,7,0,15,6,1,3465
3747,2168,5,0,7,4,1,1579
1975,4156,1,0,0,6,1,-2181
2806,4149,17,0,11,7,0,-1343
1189,3504,3,0,4,6,1,-2315
4005,2901,13,0,2,3,0,1104
3734,3048,14,0,0,3,0,686
4005,1050,18,0,3,3,0,2955
1562,1684,4,0,7,6,0,-122
2899,1716,18,0,2,4,0,1183
4638,4843,5,0,9,5,1,-205
2267,2469,16,0,1,5,1,-202
3879,1448,1,0,10,2,0,2431
2528,1880,14,0,9,5,1,648
4202,1487,15,0,20,5,0,2715
4556,2823,9,0,13,3,0,1733
4890,3081,15,0,6,3,0,1809
1646,4419,17,0,1,6,1,-2773
3068,3142,4,0,8,2,0,-74
3888,4143,12,0,15,1,0,-255
3214,2574,5,0,12,7,1,640
2297,3201,5,0,8,2,1,-904
3435,1249,11,0,19,2,1,2186
1600,1673,6,0,3,4,0,-73
3363,1437,7,0,21,6,0,1926
3061,3165,14,0,9,4,1,-104
1241,1770,11,0,21,2,0,-529
3041,4962,13,0,11,2,1,-1921
3824,4377,2,0,16,2,1,-553
4417,1267,7,0,13,5,0,3150
3612,2984,4,0,13,7,0,628
3945,2077,8,0,1,7,1,1868
2363,1235,19,0,20,4,1,1128
3139,1388,13,0,19,2,1,1751
2390,4037,14,0,10,7,1,-1647
4003,4805,10,0,15,3,0,-802
2478,1762,11,0,18,7,1,716
4499,2848,2,0,22,6,1,1651
3556,3448,9,0,5,6,1,108
1775,1623,17,0,23,7,0,152
1034,3814,3,0,18,3,0,-2780
3253,4374,6,0,4,6,1,-1121
4152,3966,5,0,3,5,0,186
2955,4278,5,0,14,7,0,-1323
2585,2252,15,0,3,5,0,333
4943,3900,17,0,19,7,1,1043
4459,4981,9,0,9,1,1,-522
4073,1577,3,0,23,1,0,2496
2021,3122,17,0,21,1,1,-1101
4461,1434,10,0,2,6,1,3027
3613,3150,3,0,4,5,0,463
2129,4493,18,0,5,5,0,-2364
4843,4775,18,0,20,5,1,68
4893,1763,17,0,21,3,0,3130
2500,3785,3,0,7,5,1,-1285
1702,3853,3,0,6,3,1,-2151
3449,2329,6,0,20,1,0,1120
3777,3145,13,0,9,1,1,632
2579,4921,15,0,5,6,1,-2342
1161,3845,9,0,13,7,0,-2684
1201,2358,4,0,3,1,0,-1157
2981,3906,14,0,12,7,0,-925
1995,3482,5,0,19,7,1,-1487
3317,1446,2,0,16,6,0,1871
4934,3017,11,0,22,2,0,1917
1815,2331,9,0,6,2,0,-516
4342,1248,3,0,3,4,0,3094
1455,1165,9,0,13,6,1,290
4533,4552,3,0,2,4,1,-19
4798,4031,2,0,23,4,0,767
2275,2358,12,0,4,2,1,-83
2016,2019,10,0,15,6,0,-3
4773,1541,9,0,22,2,0,3232
3343,1758,15,0,19,4,1,1585
4796,4177,8,0,3,6,1,619
3767,4634,5,0,23,4,0,-867
4820,3128,11,0,23,5,0,1692
1337,3180,2,0,1,7,1,-1843
1878,1796,15,0,17,6,0,82
2076,3947,6,0,18,6,1,-1871
1791,1137,8,0,18,7,0,654
4993,3231,5,0,16,4,0,1762
3264,4472,16,0,13,5,1,-1208
1763,2353,18,0,18,3,1,-590
3235,3832,6,0,21,7,1,-597
1379,4579,5,0,23,2,1,-3200
1492,2875,16,0,12,4,1,-1383
4112,4031,13,0,11,7,1,81
2180,1068,5,0,5,7,1,1112
3062,3593,13,0,20,6,0,-531
4884,4845,17,0,3,2,0,39
1064,3100,18,0,18,2,0,-2036
4928,2473,8,0,15,2,1,2455
4910,1204,13,0,12,7,1,3706
3568,3173,19,0,3,3,1,395
2367,4818,3,0,22,1,0,-2451
2152,1042,8,0,16,4,1,1110
3027,4823,2,0,22,1,1,-1796
3695,2906,8,0,0,7,0,789
2495,3158,13,0,17,1,1,-663
4134,1760,13,0,19,7,0,2374
2162,4734,1,0,16,1,0,-2572
2522,4254,6,0,14,2,1,-1732
3640,3895,19,0,10,5,1,-255
1391,3142,16,0,21,2,1,-1751
2698,2994,8,0,12,2,0,-296
1418,4445,1,0,0,6,0,-3027
3336,2935,16,0,16,6,0,401
1378,4591,9,0,5,1,1,-3213
2796,1899,13,0,3,7,1,897
4561,1359,11,0,19,2,1,3202
3278,3947,13,0,15,1,1,-669
4065,2719,10,0,14,6,0,1346
3088,1280,4,0,14,5,0,1808
4099,4266,6,0,5,4,0,-167
3182,2887,7,0,14,1,0,295
1200,4266,5,0,13,5,1,-3066
2863,1666,11,0,10,4,1,1197
1779,1092,13,0,6,3,1,687
3977,1671,19,0,8,1,0,2306
4104,2969,10,0,15,1,0,1135
4119,1060,10,0,4,3,1,3059
1502,3681,11,0,19,3,1,-2179
3454,4122,7,0,9,1,0,-668
4645,4474,18,0,17,3,1,171
2751,4860,4,0,2,2,0,-2109
1804,2028,2,0,12,4,0,-224
3146,2489,14,0,10,4,0,657
3731,1603,13,0,16,4,1,2128
2895,1681,12,0,21,2,1,1214
3773,4900,7,0,12,7,0,-1127
2570,3581,2,0,5,3,1,-1011
1960,2428,13,0,16,5,0,-468
4810,3885,14,0,12,3,0,925
3660,4584,17,0,18,1,0,-924
2485,3692,9,0,20,6,0,-1207
3690,3280,17,0,18,4,1,410
4840,1523,8,0,9,3,0,3317
2028,3393,2,0,2,5,0,-1365
4289,4117,13,0,13,1,1,172
1502,3593,3,0,18,2,0,-2091
3814,2968,16,0,4,7,0,846
1397,2101,6,0,4,2,1,-704
1870,2753,19,0,19,5,1,-883
3842,2836,7,0,16,1,1,1006
1392,4994,10,0,20,4,0,-3602
1206,4144,9,0,9,3,1,-2938
2038,3841,2,0,4,1,1,-1803
2881,3296,15,0,3,7,0,-415
4625,3094,5,0,5,2,0,1531
3939,2144,4,0,3,7,0,1795
2484,3261,4,0,6,7,0,-777
4762,3286,18,0,6,5,0,1476
4646,2079,4,0,17,5,1,2567
1863,3397,17,0,2,3,1,-1534
3790,1106,12,0,0,5,1,2684
4312,3878,17,0,23,5,0,434
1563,1047,10,0,3,1,0,516
2020,4644,1,0,5,4,0,-2624
1095,1336,18,0,8,3,1,-241
2923,2049,18,0,21,1,1,874
2757,3851,14,0,13,4,0,-1094
3532,2280,15,0,11,7,1,1252
4478,3055,12,0,19,1,0,1423
3278,1624,4,0,23,6,1,1654
3796,2890,3,0,3,1,1,906
2678,2276,12,0,20,5,1,402
4242,2715,7,0,23,4,0,1527
1540,3766,11,0,11,3,1,-2226
2059,1302,1,0,9,3,1,757
3572,1638,6,0,21,4,0,1934
2183,1055,15,0,6,5,1,1128
4910,1725,15,0,2,2,0,3185
2722,1525,19,0,22,1,0,1197
4314,1473,11,0,13,5,0,2841
4157,1027,2,0,23,6,0,3130
2819,3125,14,0,9,7,0,-306
3625,4287,2,0,15,4,1,-662
3729,4457,4,0,15,1,0,-728
3604,1364,17,0,21,3,0,2240
2597,3713,3,0,9,7,0,-1116
4060,1525,13,0,12,2,0,2535
3693,3746,9,0,5,6,1,-53
1795,2335,7,0,11,3,0,-540
2051,1882,15,0,8,4,1,169
2643,2030,11,0,12,1,0,613
4627,2026,2,0,3,4,1,2601
2363,2646,15,0,23,7,0,-283
4869,1918,14,0,10,1,0,2951
2981,3797,11,0,19,5,1,-816
2354,3410,3,0,17,2,0,-1056
2663,2774,17,0,10,5,1,-111
2529,2531,12,0,20,5,0,-2
3038,4345,15,0,3,4,1,-1307
4419,4577,16,0,17,7,0,-158
2496,3853,5,0,0,2,0,-1357
4302,3786,6,0,6,1,1,516
3237,2906,19,0,5,1,0,331
4296,4086,5,0,14,6,0,210
2408,2215,3,0,17,3,0,193
2400,2654,1,0,23,6,0,-254
2306,1484,6,0,10,6,0,822
3680,3075,15,0,19,1,0,605
3675,1713,2,0,23,4,1,1962
1972,2062,3,0,14,5,1,-90
2768,2976,17,0,15,7,1,-208
2282,2296,12,0,6,5,0,-14
4430,2254,18,0,20,5,1,2176
1709,3133,15,0,9,2,0,-1424
2479,4545,12,0,11,1,0,-2066
2434,1125,16,0,23,7,0,1309
1648,3859,8,0,13,4,0,-2211
1317,1536,14,0,4,2,1,-219
4748,3192,17,0,20,3,0,1556
4296,4596,8,0,17,4,1,-300
4890,4283,15,0,4,6,0,607
2257,3072,14,0,2,4,1,-815
1683,2603,18,0,22,4,1,-920
1663,4465,7,0,4,5,1,-2802
2998,1066,3,0,23,4,1,1932
4898,1232,12,0,16,6,1,3666
4445,3156,3,0,18,6,1,1289
4743,2169,14,0,18,1,0,2574
2631,3158,15,0,20,4,1,-527
2495,3275,14,0,11,5,0,-780
4304,1110,7,0,8,4,1,3194
4763,2493,17,0,0,3,0,2270
2136,3081,12,0,17,3,1,-945
2853,1622,4,0,20,5,1,1231
2520,4847,9,0,3,1,0,-2327
3489,4440,6,0,9,1,1,-951
1563,3795,16,0,6,6,1,-2232
2291,3642,2,0,21,6,1,-1351
4581,4625,8,0,22,2,0,-44
4878,3472,11,0,0,5,1,1406
4457,3660,13,0,16,4,0,797
4458,2541,17,0,23,7,1,1917
4184,3739,8,0,1,5,1,445
2636,2305,18,0,10,2,0,331
4696,4391,18,0,8,6,1,305
3999,2761,14,0,6,5,1,1238
4152,4514,15,0,21,5,0,-362
1698,2975,6,0,16,6,1,-1277
3160,3362,11,0,16,2,0,-202
1001,1876,13,0,1,6,0,-875
1641,2989,1,0,5,1,0,-1348
3267,4812,6,0,13,4,1,-1545
2589,4448,9,0,5,6,0,-1859
1854,2312,8,0,1,2,0,-458
2759,2460,11,0,0,3,1,299
4296,3709,19,0,9,1,0,587
3432,3324,9,0,20,3,1,108
4474,2733,17,0,4,7,1,1741
2661,2605,12,0,1,6,1,56
2153,2526,14,0,21,1,1,-373
2076,3671,15,0,15,4,0,-1595
2707,3563,16,0,1,6,0,-856
3777,4421,1,0,9,4,0,-644
2695,3890,10,0,1,5,0,-1195
2733,4517,8,0,15,3,0,-1784
2439,4901,18,0,15,1,1,-2462
3294,3397,1,0,18,4,0,-103
1835,2630,2,0,6,2,0,-795
4510,4735,1,0,21,4,0,-225
1202,3870,1,0,11,2,1,-2668
4255,2160,9,0,23,6,1,2095
1122,1758,13,0,14,1,0,-636
1400,3946,1,0,7,4,1,-2546
1766,1242,13,0,5,7,0,524
1293,3590,7,0,9,4,0,-2297
3327,2063,2,0,2,7,1,1264
4908,1228,6,0,18,1,1,3680
3931,3595,7,0,16,4,0,336
4681,1919,14,0,6,2,0,2762
1197,2246,18,0,20,4,1,-1049
4029,1005,15,0,19,3,0,3024
2930,4393,2,0,3,6,1,-1463
4582,1467,10,0,13,5,0,3115
3799,2755,12,0,19,2,1,1044
3191,1074,17,0,21,3,0,2117
1608,1003,8,0,14,7,0,605
4272,2870,11,0,23,6,1,1402
2147,1645,3,0,7,1,0,502
1186,1117,6,0,20,2,0,69
4397,3928,9,0,14,5,1,469
3511,2629,6,0,21,6,0,882
4420,3551,9,0,19,7,0,869
2794,3021,7,0,13,5,0,-227
1659,1946,9,0,8,1,1,-287
3811,3621,18,0,7,1,1,190
4002,2464,12,0,16,7,1,1538
2955,1193,8,0,1,2,0,1762
3450,1846,8,0,23,7,0,1604
2369,3762,18,0,2,4,0,-1393
2986,2415,15,0,7,1,0,571
2534,4097,7,0,11,6,1,-1563
1146,2458,11,0,0,4,0,-1312
4219,3220,16,0,9,3,0,999
3911,4371,4,0,19,5,0,-460
2734,2668,6,0,2,4,1,66
2843,3373,3,0,5,5,0,-530
1488,2433,9,0,6,7,0,-945
3976,2141,10,0,19,4,0,1835
2959,3883,14,0,22,7,0,-924
2663,2810,11,0,17,3,0,-147
3598,1723,18,0,10,1,1,1875
3385,1224,12,0,18,3,0,2161
3919,1531,12,0,4,1,0,2388
1640,1112,13,0,18,7,0,528
2802,3187,13,0,10,1,0,-385
3520,1558,19,0,23,5,0,1962
2969,3048,19,0,11,6,0,-79
3198,3137,14,0,9,3,0,61
2438,1653,4,0,7,4,0,785
4369,1319,13,0,23,3,0,3050
2634,2573,8,0,8,5,0,61
1262,2828,19,0,3,1,1,-1566
2787,2917,12,0,4,5,1,-130
3191,1138,18,0,20,2,1,2053
3393,4582,6,0,7,2,1,-1189
1623,4939,18,0,22,4,0,-3316
2016,3892,19,0,8,5,1,-1876
4643,3026,5,0,14,7,1,1617
1880,3306,9,0,14,4,0,-1426
3049,4744,3,0,15,7,1,-1695
3944,1901,10,0,13,4,1,2043
2327,1689,19,0,7,2,0,638
3301,3039,3,0,17,4,0,262
4723,1009,15,0,9,2,0,3714
1452,1260,1,0,19,1,1,192
4108,2942,7,0,5,7,1,1166
2183,2673,12,0,11,5,0,-490
4062,3219,17,0,1,4,0,843
3056,3945,5,0,6,2,1,-889
4304,3060,4,0,15,3,0,1244
4170,2191,12,0,2,7,1,1979
2682,4713,18,0,12,4,0,-2031
3863,2619,17,0,2,6,0,1244
3255,1320,19,0,17,1,1,1935
2154,2342,9,0,10,1,0,-188
1403,2636,4,0,7,3,0,-1233
3199,3376,2,0,5,2,0,-177
3101,3832,4,0,0,4,1,-731
4191,3824,2,0,0,7,0,367
2696,2994,15,0,22,2,0,-298
4991,3958,2,0,7,1,0,1033
1627,2943,4,0,4,2,0,-1316
1586,4621,6,0,15,1,0,-3035
2648,3038,7,0,10,2,0,-390
2443,4490,10,0,4,3,1,-2047
2445,4677,19,0,3,5,1,-2232
1103,2118,19,0,5,3,0,-1015
4923,4888,12,0,13,3,1,35
1253,2604,3,0,21,5,1,-1351
4298,3365,13,0,18,5,0,933
4183,1235,18,0,8,4,1,2948
3557,2969,8,0,11,7,1,588
2496,1333,15,0,10,7,1,1163
1098,2908,1,0,13,4,1,-1810
3200,1375,3,0,22,3,1,1825
2884,4530,8,0,15,3,1,-1646
3961,2160,4,0,0,1,1,1801
2919,3635,16,0,12,1,1,-716
1877,2570,10,0,22,7,0,-693
1337,3560,12,0,20,4,0,-2223
4777,2319,14,0,20,6,1,2458
3869,4391,14,0,12,6,1,-522
4234,3965,2,0,1,4,0,269
4791,4643,5,0,3,1,1,148
1956,2855,5,0,5,7,1,-899
2704,2372,6,0,22,7,0,332
1160,4911,13,0,4,1,0,-3751
2603,4850,9,0,2,6,0,-2247
3848,1872,15,0,0,2,1,1976
1397,2252,14,0,3,2,1,-855
2300,3317,7,0,19,1,0,-1017
1815,2851,2,0,1,2,0,-1036
4987,3845,7,0,4,5,1,1142
2527,2314,6,0,2,4,0,213
2919,1724,17,0,8,4,1,1195
2415,4236,2,0,19,1,1,-1821
2158,3052,3,0,5,3,0,-894
2218,3898,5,0,17,6,0,-1680
1400,4450,5,0,5,1,1,-3050
1639,1077,1,0,18,2,0,562
4104,4481,8,0,11,6,0,-377
3735,3621,12,0,10,3,0,114
1459,1131,4,0,1,2,0,328
1954,1600,13,0,14,7,1,354
4954,2772,15,0,11,5,1,2182
1469,2065,11,0,11,2,1,-596
4446,3136,10,0,8,5,1,1310
2045,3449,3,0,20,6,0,-1404
3797,3343,14,0,23,5,0,454
2693,2863,16,0,1,6,1,-170
3085,2318,10,0,21,6,1,767
3277,1615,10,0,2,6,0,1662
4436,4597,12,0,11,6,1,-161
1562,3847,9,0,15,6,1,-2285
3485,4762,1,0,20,2,0,-1277
2799,4708,5,0,23,6,1,-1909
4354,3469,8,0,0,2,0,885
3074,2888,11,0,20,6,0,186
1225,2046,12,0,2,5,1,-821
4348,1574,1,0,19,7,0,2774
1797,3190,11,0,1,6,1,-1393
4680,1992,5,0,8,3,0,2688
3331,3712,15,0,18,6,1,-381
3926,3192,5,0,14,6,1,734
1959,2248,12,0,17,5,1,-289
2504,4054,5,0,10,4,0,-1550
1452,1502,17,0,22,5,0,-50
4067,2997,17,0,15,3,1,1070
4900,1820,12,0,21,4,0,3080
1815,4687,15,0,16,1,1,-2872
1658,3151,15,0,4,1,1,-1493
4587,4110,6,0,11,3,0,477
1546,2970,12,0,10,5,1,-1424
2215,1197,18,0,14,2,0,1018
4120,2669,14,0,2,3,1,1451
4583,3626,2,0,0,7,0,957
1016,3438,9,0,19,4,1,-2422
4243,2202,5,0,15,4,1,2041
2243,3601,1,0,1,6,0,-1358
3205,2471,3,0,1,1,1,734
3524,4571,6,0,2,4,1,-1047
2069,4086,5,0,7,3,0,-2017
4444,2646,5,0,23,4,1,1798
3565,2692,1,0,14,3,0,873
3146,2312,17,0,6,2,1,834
4963,3035,19,0,5,6,0,1928
2768,1477,14,0,8,1,1,1291
2060,2254,12,0,19,4,1,-194
3327,1922,10,0,0,3,1,1405
4420,1419,18,0,7,5,0,3001
3544,3204,11,0,22,1,0,340
1301,3597,2,0,22,2,0,-2296
1180,4512,18,0,2,3,0,-3332
1606,2120,7,0,3,7,1,-514
4170,4068,15,0,14,7,1,102
1699,4044,11,0,5,6,0,-2345
1992,4482,18,0,14,6,0,-2490
2139,1950,12,0,20,2,0,189
1190,3336,6,0,2,2,1,-2146
3300,2277,13,0,20,6,0,1023
1980,3243,16,0,20,4,0,-1263
3975,3645,18,0,13,4,1,330
3006,2857,10,0,19,3,1,149
2184,4593,8,0,13,5,0,-2409
4327,1516,18,0,3,3,1,2811
4394,2658,1,0,11,5,0,1736
1127,2865,8,0,16,2,1,-1738
3065,3912,6,0,6,1,0,-847
2816,2141,5,0,8,3,0,675
2758,3853,15,0,2,3,0,-1095
3613,2932,15,0,12,5,0,681
1569,4230,2,0,14,2,1,-2661
2346,1814,1,0,17,2,1,532
2895,3275,11,0,18,7,1,-380
3733,2900,10,0,0,5,1,833
4863,3263,18,0,5,2,0,1600
1625,3995,18,0,22,6,0,-2370
4359,4767,17,0,1,4,1,-408
3901,3062,8,0,23,7,1,839
2686,4228,15,0,13,6,1,-1542
4009,4719,8,0,5,1,1,-710
4710,4332,17,0,13,3,1,378
1154,4228,12,0,3,7,0,-3074
3537,3094,8,0,20,1,0,443
2409,3371,14,0,7,3,0,-962
1784,3891,4,0,2,4,1,-2107
4175,4756,1,0,18,2,1,-581
4464,1129,1,0,13,6,1,3335
4882,4482,19,0,19,5,1,400
1245,1094,16,0,16,6,0,151
4247,3674,14,0,7,4,0,573
4110,3802,16,0,23,1,1,308
2500,2955,5,0,13,5,0,-455
2705,4363,9,0,5,2,0,-1658
3806,1793,2,0,22,4,1,2013
1537,2834,18,0,21,5,1,-1297
2890,4354,6,0,15,4,1,-1464
2841,3116,9,0,18,4,1,-275
1920,2683,1,0,13,2,1,-763
3455,1010,9,0,18,7,1,2445
1524,4325,16,0,2,3,0,-2801
3875,2865,13,0,9,5,0,1010
2529,3919,9,0,18,2,1,-1390
3950,3597,13,0,8,4,0,353
4896,4205,9,0,19,2,1,691
1035,1711,11,0,12,7,1,-676
1684,3070,4,0,6,3,1,-1386
1019,1814,2,0,13,6,1,-795
3368,1345,6,0,8,5,0,2023
4847,3349,14,0,22,3,1,1498
3559,1362,4,0,18,1,0,2197
1399,3443,6,0,14,5,1,-2044
3701,3265,19,0,19,3,1,436
1971,3188,6,0,13,4,1,-1217
2906,4687,2,0,23,5,0,-1781
3518,4005,18,0,5,5,1,-487
2166,4281,13,0,20,2,1,-2115
2115,1984,9,0,3,4,1,131
4425,4040,19,0,7,1,0,385
1833,4694,13,0,16,6,0,-2861
2823,2639,11,0,8,7,0,184
3774,1827,1,0,0,3,1,1947
2982,3730,7,0,23,2,0,-748
1853,4531,15,0,19,3,1,-2678
1050,4051,1,0,13,1,0,-3001
4736,1355,12,0,10,1,0,3381
4769,4055,7,0,20,5,1,714
1574,2347,15,0,2,7,0,-773
4261,4204,19,0,8,1,1,57
2148,3935,1,0,13,3,1,-1787
3197,4876,17,0,8,4,0,-1679
3361,2863,17,0,3,4,1,498
3617,1126,3,0,3,5,1,2491
4413,4177,12,0,7,6,0,236
3352,4056,6,0,1,3,0,-704
2715,1603,11,0,8,3,1,1112
1681,4870,3,0,13,1,0,-3189
1837,4449,8,0,21,7,1,-2612
4854,2928,14,0,8,3,1,1926
2077,2013,14,0,23,2,0,64
4050,1050,10,0,22,6,0,3000
3491,4100,2,0,15,1,0,-609
3660,4533,14,0,16,2,0,-873
4040,4367,9,0,15,5,1,-327
3311,4368,3,0,11,4,1,-1057
4124,4797,8,0,2,5,0,-673
2595,3826,16,0,10,4,0,-1231
4051,2430,2,0,13,5,1,1621
4691,2792,6,0,17,3,1,1899
1004,3861,12,0,20,2,1,-2857
2126,2636,5,0,20,4,1,-510
2219,4476,2,0,4,1,0,-2257
1773,4417,16,0,15,2,1,-2644
1876,2645,5,0,19,1,1,-769
1991,3467,15,0,4,2,0,-1476
3931,2205,12,0,2,2,1,1726
4421,4030,4,0,11,5,1,391
1046,3872,15,0,0,4,0,-2826
3914,4072,11,0,20,4,0,-158
3870,2854,16,0,8,7,0,1016
3983,1566,6,0,8,2,1,2417
4891,3418,14,0,3,3,1,1473
3703,1935,18,0,2,3,0,1768
1268,2934,12,0,16,1,0,-1666
1369,3708,11,0,1,1,1,-2339
1635,4502,13,0,23,5,0,-2867
2129,4016,11,0,0,2,0,-1887
2693,2332,16,0,7,1,0,361
2682,4208,15,0,12,1,1,-1526
1656,1201,15,0,22,6,1,455
1119,4507,4,0,14,2,1,-3388
1830,3360,11,0,7,5,1,-1530
2810,1116,19,0,11,1,1,1694
4675,4737,15,0,21,5,1,-62
2081,1936,4,0,11,4,0,145
2974,4874,13,0,13,5,1,-1900
2369,1574,19,0,14,3,1,795
1740,3291,2,0,14,3,0,-1551
4545,1536,14,0,8,5,1,3009
1116,2625,4,0,18,3,1,-1509
2853,3122,16,0,19,4,0,-269
3838,4877,14,0,21,2,0,-1039
2150,1385,15,0,7,3,0,765
4464,4974,3,0,20,3,1,-510
2931,4281,8,0,18,5,0,-1350
2012,1474,16,0,5,4,1,538
2664,1417,10,0,19,7,1,1247
2081,3394,4,0,18,7,1,-1313
1633,4600,18,0,3,7,1,-2967
1512,3687,2,0,22,7,0,-2175
4822,1938,17,0,6,2,0,2884
3849,1954,13,0,3,5,1,1895
2119,1875,4,0,21,5,0,244
4709,1762,11,0,11,6,1,2947
2141,2202,7,0,12,4,1,-61
1559,2205,12,0,2,7,1,-646
4672,1663,10,0,21,2,0,3009
1487,1024,7,0,11,4,1,463
4308,2990,13,0,1,7,1,1318
4956,2203,7,0,23,2,0,2753
1896,1709,17,0,1,4,0,187
4343,4572,10,0,22,5,0,-229
2212,2879,10,0,8,5,0,-667
1703,2184,4,0,0,1,1,-481
2470,3224,4,0,7,3,0,-754
1580,1284,7,0,22,7,1,296
3837,1062,1,0,5,6,0,2775
3908,2002,12,0,5,4,0,1906
3294,1661,13,0,21,6,0,1633
4147,3713,10,0,17,1,0,434
1153,3203,15,0,16,3,0,-2050
2679,4953,13,0,11,4,0,-2274
4506,2492,9,0,5,2,1,2014
1996,4120,9,0,7,7,0,-2124
4157,1966,15,0,18,3,0,2191
3744,1848,10,0,9,5,0,1896
4356,2107,10,0,0,1,0,2249
2243,4432,8,0,12,3,1,-2189
2092,1688,16,0,16,7,0,404
4118,1147,17,0,2,3,0,2971
2008,4701,5,0,7,7,0,-2693
3141,1341,4,0,13,5,0,1800
2773,3523,18,0,2,4,1,-750
1957,2086,19,0,15,2,0,-129
4059,2724,4,0,12,5,1,1335
1452,2383,7,0,19,2,0,-931
2227,3608,10,0,23,4,1,-1381
3959,1326,18,0,16,3,1,2633
3265,2792,19,0,12,2,0,473
3521,2759,4,0,5,1,0,762
3479,4212,10,0,16,1,1,-733
3388,1989,1,0,13,7,1,1399
1550,3262,18,0,16,5,0,-1712
2635,3482,5,0,7,4,1,-847
2312,4962,15,0,10,7,1,-2650
4325,1951,17,0,19,5,1,2374
2757,1722,3,0,0,5,0,1035
1356,4389,12,0,6,7,1,-3033
3070,3079,2,0,20,6,1,-9
2785,3717,1,0,20,5,1,-932
3569,3332,17,0,16,6,0,237
2781,4376,16,0,9,1,0,-1595
4908,1428,5,0,10,1,1,3480
4171,2500,15,0,21,5,0,1671
3849,1285,3,0,8,1,1,2564
4251,4215,7,0,8,4,0,36
4294,4495,11,0,23,6,0,-201
4977,4090,10,0,4,6,1,887
3809,3065,9,0,16,5,0,744
4730,1768,14,0,8,1,0,2962
3489,3637,13,0,16,2,0,-148
2631,2394,2,0,23,7,1,237
3816,4246,3,0,20,7,0,-430
2015,4057,7,0,18,6,0,-2042
2348,1193,18,0,6,5,1,1155
1515,3549,3,0,22,5,0,-2034
4087,1987,10,0,8,4,0,2100
3839,2136,7,0,6,3,0,1703
1335,3161,9,0,12,3,0,-1826
2782,4293,17,0,10,6,0,-1511
3305,2701,11,0,13,7,1,604
1496,1946,7,0,18,4,1,-450
1895,1830,14,0,10,4,0,65
3207,4715,19,0,12,4,0,-1508
4546,2920,4,0,13,6,0,1626
1851,4335,6,0,12,3,1,-2484
2687,3972,10,0,0,7,1,-1285
2931,1054,7,0,7,4,0,1877
3737,4942,13,0,11,7,0,-1205
4746,4714,14,0,18,1,1,32
3427,1799,4,0,11,5,0,1628
2568,1777,8,0,7,5,1,791
1956,2481,5,0,7,7,1,-525
3738,2901,1,0,20,2,0,837
4498,3209,4,0,12,2,1,1289
2636,4451,3,0,11,6,0,-1815
2291,3134,9,0,15,6,0,-843
4906,1054,8,0,0,5,0,3852
4648,4547,1,0,12,1,0,101
2440,2823,6,0,6,3,0,-383
2191,2201,9,0,4,3,0,-10
4913,4462,7,0,7,6,1,451
2066,4420,4,0,13,1,1,-2354
4627,4079,13,0,22,6,1,548
1284,1832,17,0,12,3,1,-548
3444,1312,2,0,14,7,0,2132
1011,3806,5,0,22,6,1,-2795
2630,2858,12,0,16,4,1,-228
4373,3007,8,0,14,7,1,1366
4969,3006,6,0,19,6,0,1963
4324,3490,8,0,17,5,1,834
3546,2790,18,0,17,6,0,756
1753,1327,3,0,1,5,1,426
3082,4125,12,0,3,1,0,-1043
3774,3808,3,0,0,3,0,-34
3896,4310,6,0,3,7,1,-414
1089,4300,2,0,17,7,0,-3211
1775,3626,12,0,4,2,0,-1851
3652,4122,2,0,18,2,1,-470
4993,4680,6,0,14,3,1,313
4017,4675,17,0,7,2,1,-658
2625,4054,3,0,19,7,0,-1429
4069,2287,2,0,16,6,0,1782
1417,4489,8,0,0,1,0,-3072
1114,4874,12,0,11,1,1,-3760
1616,3143,4,0,18,3,0,-1527
4974,2111,5,0,14,2,0,2863
4267,4149,13,0,8,6,0,118
1825,2311,15,0,6,1,0,-486
4572,4191,16,0,1,1,0,381
2649,3861,10,0,8,4,0,-1212
2516,3538,16,0,9,4,0,-1022
4146,4983,12,0,1,7,1,-837
1412,1451,17,0,18,1,1,-39
4447,2523,16,0,10,3,1,1924
4491,1164,12,0,12,5,0,3327
1728,1181,8,0,9,5,0,547
4348,3516,3,0,13,6,1,832
4068,1909,16,0,17,1,0,2159
3808,3782,13,0,18,1,1,26
1675,1822,19,0,21,7,0,-147
4465,1943,8,0,8,1,0,2522
2892,3001,5,0,6,3,1,-109
3504,3054,8,0,2,4,1,450
3967,1329,12,0,19,1,1,2638
3239,1774,1,0,5,1,1,1465
3786,4744,6,0,20,7,1,-958
4760,3198,18,0,1,2,0,1562
2122,4156,8,0,5,7,0,-2034
2571,1146,7,0,2,7,0,1425
1977,4695,1,0,15,3,1,-2718
2008,4452,16,0,7,6,1,-2444
3143,1914,12,0,1,1,1,1229
2687,2571,6,0,16,7,1,116
3710,2308,2,0,8,7,1,1402
4261,3747,14,0,11,2,1,514
4807,1081,4,0,2,7,0,3726
1036,1513,1,0,10,5,0,-477
4851,2920,18,0,0,6,0,1931
4440,3862,13,0,22,1,0,578
4766,3756,2,0,12,1,0,1010
2548,2939,9,0,14,2,1,-391
3326,4594,2,0,4,3,1,-1268
3264,1745,9,0,20,1,1,1519
3914,4070,1,0,16,5,1,-156
1872,2409,11,0,22,1,1,-537
2821,1706,3,0,23,5,1,1115
2296,1470,4,0,5,6,0,826
4952,4190,18,0,20,6,1,762
3109,1395,6,0,21,4,1,1714
1595,2555,3,0,10,4,1,-960
2903,3308,11,0,17,5,1,-405
1728,1804,15,0,3,3,0,-76
2365,1933,5,0,2,1,0,432
1396,2279,10,0,12,7,1,-883
1698,2757,12,0,22,1,0,-1059
4090,1904,15,0,8,4,0,2186
3224,4297,17,0,20,7,1,-1073
2635,2076,10,0,5,5,1,559
1395,3987,6,0,11,7,1,-2592
3492,2890,18,0,1,1,1,602
4304,2523,13,0,2,1,1,1781
4986,4577,3,0,2,3,0,409
1075,3901,10,0,11,2,1,-2826
1264,2387,14,0,14,7,1,-1123
3502,2303,6,0,8,4,1,1199
2819,1592,3,0,22,4,0,1227
1717,3761,16,0,7,2,1,-2044
3782,4229,7,0,10,1,1,-447
4455,3679,14,0,15,3,1,776
4635,3106,9,0,21,3,0,1529
1850,4798,15,0,3,4,1,-2948
4577,1127,3,0,0,3,1,3450
2390,1735,2,0,23,6,1,655
1143,3768,2,0,6,2,0,-2625
1884,4953,3,0,1,1,1,-3069
4140,4186,18,0,23,6,1,-46
4170,4280,14,0,4,2,1,-110
1395,3573,18,0,6,5,0,-2178
4096,1520,10,0,3,7,1,2576
3995,3599,2,0,4,4,1,396
3938,1236,1,0,23,3,1,2702
2492,2304,4,0,0,5,0,188
4555,4430,14,0,0,3,0,125
4636,4272,1,0,14,6,1,364
4222,2781,14,0,19,1,0,1441
2167,2301,16,0,18,1,0,-134
3616,4306,14,0,9,1,0,-690
2062,3541,3,0,17,3,1,-1479
3156,3051,3,0,2,5,1,105
4764,3713,9,0,10,1,0,1051
2065,1441,6,0,14,5,0,624
2209,3076,13,0,10,3,0,-867
3982,4180,2,0,16,6,1,-198
3445,3657,8,0,16,5,1,-212
4294,4798,2,0,5,6,0,-504
1633,1804,4,0,4,3,0,-171
2156,1074,15,0,7,3,0,1082
4234,3885,4,0,1,4,0,349
2238,4217,13,0,15,3,1,-1979
1732,3175,12,0,19,3,0,-1443
1234,4924,13,0,23,2,1,-3690
4914,3089,14,0,11,1,0,1825
3705,2379,18,0,5,4,0,1326
1750,1040,6,0,0,7,0,710
3635,3981,11,0,3,4,0,-346
4080,3081,2,0,16,4,0,999
4145,4088,19,0,12,7,1,57
1953,2700,19,0,17,2,0,-747
3539,4224,5,0,4,6,0,-685
3960,4045,19,0,23,3,0,-85
4324,2401,2,0,23,1,1,1923
4301,1587,10,0,2,5,1,2714
2542,2622,2,0,10,7,1,-80
2197,4700,11,0,12,6,1,-2503
2676,4945,18,0,3,7,0,-2269
2191,1341,15,0,13,3,0,850
3217,3074,9,0,21,2,0,143
2416,4896,19,0,10,7,1,-2480
3993,4358,9,0,9,3,0,-365
3842,1645,3,0,18,3,0,2197
3681,1730,9,0,17,2,1,1951
2217,1167,14,0,5,4,1,1050
2540,1609,19,0,14,4,1,931
3076,3315,7,0,20,1,0,-239
4236,2772,16,0,9,1,0,1464
2445,3040,16,0,4,4,1,-595
3386,3868,1,0,4,6,0,-482
4719,1454,4,0,9,5,1,3265
2519,3953,4,0,4,3,1,-1434
2388,2708,7,0,2,5,0,-320
2856,4472,8,0,22,3,1,-1616
2365,3969,17,0,5,4,1,-1604
1499,4028,5,0,3,1,1,-2529
2680,4547,7,0,17,6,0,-1867
1510,1701,4,0,8,1,1,-191
4398,3681,6,0,16,5,1,717
1216,4629,7,0,12,1,1,-3413
2324,2599,18,0,14,4,1,-275
2155,1129,5,0,19,6,1,1026
2827,4067,3,0,16,5,1,-1240
4141,2845,7,0,12,6,1,1296
4323,2386,14,0,15,3,0,1937
4486,4776,7,0,21,1,0,-290
2810,3866,5,0,3,6,1,-1056
3492,1692,5,0,4,2,0,1800
3923,4363,2,0,4,1,0,-440
2205,2394,6,0,8,3,1,-189
3214,1793,15,0,16,6,0,1421
1090,1028,10,0,12,5,1,62
1713,1148,7,0,1,3,1,565
2881,4850,5,0,12,2,1,-1969
4602,2319,1,0,21,6,1,2283
1038,3058,13,0,20,7,1,-2020
4197,4583,18,0,22,7,0,-386
4522,3723,13,0,18,4,1,799
1172,2136,18,0,2,1,0,-964
1652,1186,5,0,9,5,1,466
1753,3854,13,0,1,4,1,-2101
2243,3791,4,0,12,6,1,-1548
4709,2250,17,0,18,7,0,2459
2081,2333,3,0,16,7,1,-252
2683,1097,17,0,20,7,1,1586
3523,1054,11,0,13,6,1,2469
1455,3670,4,0,11,7,1,-2215
1828,3711,2,0,20,3,0,-1883
1894,1757,16,0,11,6,1,137
2384,1405,18,0,10,5,0,979
2958,3116,8,0,6,4,1,-158
4072,4383,3,0,3,5,0,-311
3434,2312,9,0,18,2,0,1122
2996,2785,6,0,0,7,1,211
3395,4619,10,0,23,2,1,-1224
1189,1750,10,0,2,1,0,-561
1504,4219,13,0,12,1,1,-2715
2214,4538,17,0,14,2,1,-2324
2531,2762,9,0,1,6,1,-231
4440,4315,17,0,10,5,0,125
4480,4562,9,0,3,2,1,-82
1823,4920,9,0,18,1,1,-3097
1928,4005,1,0,16,2,1,-2077
1933,4578,2,0,2,6,0,-2645
2140,1364,16,0,17,2,1,776
1133,3026,1,0,7,5,0,-1893
3105,1481,10,0,21,4,1,1624
4627,3248,18,0,23,6,0,1379
1684,1153,8,0,18,1,1,531
3719,4521,11,0,4,5,1,-802
3220,2524,2,0,6,2,0,696
2852,3120,8,0,20,2,0,-268
1814,3760,8,0,7,4,0,-1946
2172,3343,17,0,4,1,1,-1171
1079,2040,15,0,16,1,1,-961
3933,2664,17,0,4,3,1,1269
4284,2240,13,0,3,1,1,2044
1202,1060,19,0,21,4,0,142
3811,1938,5,0,18,7,1,1873
2252,2639,12,0,20,3,1,-387
2699,3089,1,0,1,3,1,-390
2250,1024,5,0,10,2,1,1226
2682,2062,8,0,21,2,1,620
2555,4874,13,0,12,1,1,-2319
4512,1130,8,0,14,3,1,3382
4473,4569,11,0,11,2,0,-96
3094,2252,1,0,21,4,1,842
2256,1107,13,0,20,2,1,1149
4376,1171,19,0,21,6,1,3205
2549,2458,3,0,10,6,1,91
2166,4549,17,0,6,2,0,-2383
4486,1101,5,0,4,3,0,3385
4584,3913,8,0,16,7,0,671
2396,3571,14,0,23,7,0,-1175
4637,3322,4,0,19,3,0,1315
4957,2636,11,0,8,5,0,2321
4330,4115,15,0,13,7,1,215
3703,3864,19,0,11,6,0,-161
1470,4004,7,0,5,4,0,-2534
4018,2040,19,0,16,3,1,1978
2035,1329,19,0,18,1,0,706
2353,4640,11,0,18,6,1,-2287
3783,4894,5,0,15,4,1,-1111
3831,2520,5,0,11,4,0,1311
1967,4886,8,0,11,3,1,-2919
1357,1011,10,0,19,4,0,346
4019,2341,6,0,5,3,0,1678
4479,4663,15,0,22,7,1,-184
1667,1215,16,0,3,2,1,452
1372,1338,17,0,5,6,0,34
2031,2799,8,0,10,5,1,-768
2145,3708,8,0,0,2,1,-1563
2371,4152,9,0,23,6,0,-1781
3723,2750,2,0,22,3,0,973
1089,2508,15,0,14,6,1,-1419
4719,3421,18,0,10,7,0,1298
3745,4023,3,0,18,3,0,-278
4387,1709,17,0,17,2,0,2678
4249,2223,4,0,16,1,0,2026
1539,4608,4,0,18,1,0,-3069
3779,3513,14,0,20,6,0,266
1868,2112,9,0,13,1,0,-244
1040,2291,9,0,17,3,1,-1251
1739,4726,18,0,18,4,0,-2987
4775,4642,10,0,14,3,1,133
2946,4993,4,0,14,4,1,-2047
3549,1488,12,0,3,2,1,2061
4006,4948,8,0,6,5,0,-942
4216,2561,2,0,12,4,0,1655
2224,1046,13,0,2,1,1,1178
1928,4359,16,0,15,3,0,-2431
3036,1777,2,0,8,2,1,1259
4795,2039,11,0,7,1,0,2756
3508,1710,10,0,19,2,0,1798
3779,1400,15,0,12,5,1,2379
3799,4990,17,0,16,7,1,-1191
1924,2817,8,0,16,3,1,-893
3956,4028,18,0,16,6,0,-72
2581,4157,9,0,0,3,1,-1576
4618,1249,8,0,7,5,0,3369
4324,1390,14,0,18,3,0,2934
1389,4853,18,0,5,6,0,-3464
2617,1334,12,0,2,4,1,1283
3930,1628,19,0,4,2,1,2302
1255,4590,14,0,12,6,1,-3335
1708,1136,17,0,14,1,0,572
2838,3930,3,0,13,5,0,-1092
2944,3735,7,0,22,4,1,-791
3497,4911,17,0,15,1,0,-1414
1009,2521,12,0,17,1,0,-1512
3871,1826,9,0,21,5,1,2045
1797,1726,15,0,21,4,1,71
4313,2500,18,0,10,7,1,1813
